0000000000000000000000000000000000000000000000000000000000000000000000000000000
0000000000000000000000000000000000000000000000000000000000000000000000000000000
0000011110000000000000000000000000000000000000110000000000001110000000000000000
0000011110000000000000000000000000000000000000110111111111001110000000000000000
0111011110000000000000000000000000000000000000110111111111001110000000000000000
0000011110000000000000000000000000000000000000000111111111000000000000000000000
0000011110000000000000000000000000000000000000000000000000000000000000000000000
0000011110000000000000000000000000000000000000000000000000000000000000000000000
0001111110000000000000000111110000000000000000000000000000000000000000000000000
0001111110000000000000000111111110000000000000000000000000000000000000000000000
0000000000000000000000000111111110000000000000000000000000000000000000000000000
0000000000000000000000000111110000000000000000000000000000000000000000000000000
0000000000000000000000000111110000000000000000000000000000000000000000000000000
0000000000000000000000000111110000000000000000000000000000000000000000000000000
0000000000000000000000000000000000000000000000000000000000000000000000000011100
0000000000000000000000000000000000000000000000000000000000000000000000000011100
0000000000000000011111110000000000000111111000000000000000000000000000000011100
0000000000000000011111110000000000000111111000000000000000000000000000000000000
0000000000000000011111110000000000000111111000000000000000000000000000000000000
0000000000000000011111110000000000000111111000000000000000000000000001111111110
0000000000000000000000000000000000000000000000000000000000000000000001111111110
0000000000000000000000000000000000000000000000000000000000000000000001111111110
0000000000000000000000000000000000000000000000000000000000000000000001111111110
0000000000000000000000000000000000000000000000000000000000000000000000000000000
0000000000000000000000000000000011111111100000000000000000000000000000000000000
0000000000000000000000000000000011111111100000000000000000000000000000000000000
0000000000000000000000000000000011111111100000000000000000000000000000000000000
0000000000000000000000000000000011111111100000000000000000000000000000000000000
0000000000000000000000000000000001111001111000000001111110011111110000000000000
0000000000000000000000000000000001111001111001110001111110011111110000000000000
0000000000000000000000000000000001111000000001110000001111111110000011100000000
0000000000000000000000000000000001111000000001110000000011100000000011100000000
0000000000000000000000000000000001111000000001110000000011100000000011100000000
0000000000000000000000000000000001111000000001110000000011100000000011100000000
0000000000000000000000000000000001111000000001110000000011100000000011100000000
0000000000000000000000000000000001111000000001110000000011100000000011100000000
0000000000000000000000000000000001111000000001110000000011100000000011100000000
0000000000000000000000000000000000000000000001110000000011100000000011100000000
0000000000000000000000000000000000000000000001110000000011100000000011100000000
0000000000000000000000000000000000000000000001110000000011100000000011100000000